11111111111
11P10011111
100011110C1
1101C011111
10000EC0C11
10011001011
10100100101
11101111111
11111001111
11101011101
10011111111
11000011111
11111111111
