1111111111111
10010P000C001
1000011111011
100011E000001
1111111111111
