11111111111111
11110011101011
11000000011001
11100000001101
100001010C0001
110C0110000101
100E0011001011
11100100111001
1010010010P111
11111110011111
1C10110011C001
10000110100001
10010000000011
11111111111111
