1111111111111
100000000C001
1011111111111
1011111111011
1P0000E000001
1111111111111
