1111111111
1P000000E1
1000000001
10000C0001
1000000001
1111111111
