1111111111111
100000000C001
1011111111011
1011111111011
1P1111E000001
1111111111111
