111111111111111
10CC110111110C1
110011010101011
111E0111100C011
110010001101001
111101001111101
110011011011111
110011111101111
1011P0111011001
101101110010011
100000101111011
100011011001101
1C0011111101011
1101111011C1011
101111111111011
111111111111111
