111111111111111111
1010101010010C0111
100P10010000001101
101000010000001001
10111010011100C011
1C1100C11000001011
100010010010000101
110011000000100E01
111111000101000011
100011001011000001
101110001000000101
111111111111111111
