11111111111111
1C01011010E111
11011110110111
100C1101110101
111101C1101101
10011100110001
10100110100001
10001000C01111
10111010000111
10111111111011
10111011110111
10001110111001
111P110CC11111
1101110011C111
11111111111111
