111111111111
1P1010101011
111001111C11
110111110001
110111011111
11C0C0111011
10C111110001
110001110111
101111000111
111011101101
1110111110E1
1110011C1101
100100110101
111011011101
110001111011
111111111111
