111111111111
1110101C1101
111011011101
111110010101
111111101111
1001C1000111
1011C1110101
110010111101
11110E010101
111P01C01111
1C1100011011
111010111111
111111C00011
111111011111
110011101011
101011110101
111111111111
