111111111111111
10110C1C0010111
100000010010011
110101001001001
1110001E0011101
10110P000101001
110111000110001
101001011000001
101C1100C100101
110001000000101
101010001001101
101010100101011
111111110000C11
100011101110111
100000110000001
110101000110011
111111111111111
