1111111
1000011
1X01011
1C1E001
1001111
110P101
1101101
1111111
