1111111111111111111
1011111011111110011
1111111110111101001
11111E01111010C0C11
1110011110000101011
1011011100011110111
1110111101111001111
1111011011011011001
1011101110110C11011
1111101011001101111
1111010111011C11101
1001100101011010001
10000001P1010011111
1111111111111111111
