111111111111
100110111011
1110E0000011
10010011C1C1
110000000P01
100001000111
101111000001
111L110001C1
111111111111
