1111111111111111111111111111111111111111111111111
10110000101111001110100110010010110C0011010101011
1001101010111000001100011100000010100111100101101
1011110110000011011101100100010000001000100000101
1100010111101010111100001101001001001010000001001
1100000010111011000000000011011000001111110100011
1000101011011001000001001001000001100010011110101
100100100010110001100000C000000000101010100000101
1101001010011101010100011010100010110000010000001
10001000010111100000110110000110101001000C0101101
1110000000000001000001010001000001011E00100110001
1010010010110010000010111000000111101100111111101
1011101001100010101000011001000000000011000000011
1000101100001100000001001011000001001011000010001
1110110100010010100001101000000010001110000100001
1100000010110000010011100011010100111000100111011
1011001000100001100011000000101101110110000010011
100001P100000001010101000010000010011001110101101
1111000001C10101110100111110011010100110000010001
1111111111111111111111111111111111111111111111111
