11111111111111111111111111111
101C1010101010101010101010101
10101010101010101010101010101
10101010101010101010101010101
10101010101010101010101010101
1P00000E101010101010101010101
11111111111111111111111111111
