1111111111111111111111111111111111111111111
1001010101000000011001001111100001100100101
1000000110C00010011111110001101101000110011
10C1100100101010E11001111001001110000011111
101001001000P000100001101001000110011000111
1110000111110000100100010101000000010000001
1101101000C110010000010001C0101110110100011
101101111101110101100001000010001000000C001
1110C111001110010000001011001010000C1101101
101001101010000C111010000100101111011010011
1111000011010110011100101110000011100100111
1111111111111111111111111111111111111111111
