11111111111111111111
11EPC001000000000001
11111100000000000001
11111100000000000001
1111110000000C000001
11111100000000000001
11111100000000000001
11111111111111111111

