1
11
101
1011
10111
1C1101
1000101
11001101
111111001
10PE110011
10111000101
111111111111
